00000000000000000000000000000000
00000000000000000000000000000000
00000000000000000000000000000000
00000000000000000000000000000000
00001110111011101110111011100000
00001010100010001000101010000000
00001110100010001000101010000000
00001000100010001000101010000000
00001110100010001000111010000000
00000000000000000000000000000000
00000000000000000000000000000000
00000001100000000000000000000000
00000000011000000000000000000000
11110000000110000000000000000000
00000000000000110000000000000000
11111111111111111111111111111111
11111111111111111111111111111111
11111111111111111111111111111111